none
2
4 4
1 1 1 1
1 0 0 1
1 49 1 1
1 0 1 1
-
3 6
1 1 2 1 1 1
1 0 0 0 0 0
1 1 1 1 1 1